%%%%%%%%%%
%        %
% ...%...%
% .%.%.%.%
% .%.%.%.%
% .%.%.%.%
% .%.%.%.%
% .%.%.%.%
%P.%...%.%
%        %
%%%%%%%%%%