%%%%%%%%
%.%....%
%.% %%.%
%.%P%%.%
%...  .%
%%%%%%%%